absense - absence
adress - address
alot - a lot
aquit - acquit
arguement - argument
artic - arctic
begining - beginning
beleive - believe
broccolli - broccoli
borough and bureau are confused
calender - calendar
comraderie - camaraderie
cieling - ceiling
cemetary - cemetery
changable - changeable
collegue - colleague
consciencious - conscientious
concious - conscious
daquiri - daiquiri
decieve - deceive
definately - definitely
desparate - desperate
disasterous - disastrous
dumbell - dumbbell
embarass - embarrass
enviroment - environment
existance - existence
experiance - experience
facinating - fascinating
Febuary - February
firey - fiery
flourescent - fluorescent
foriegn - foreign
goverment - government
gratefull - grateful
greatful - grateful
garantee - guarantee
harrass - harass
hieght - height
hipocrite - hypocrite
humerous - humorous
innoculate - inoculate
independant - independent
jewelry - jewelery
kernal - kernel
liesure - leisure
liason - liaison
libary - library
lisense - license
maintainance - maintenance
medevil or mideval - medieval
millenium - millennium
miniture - miniature
miniscule - minuscule
mischievious - mischievous
mispell - misspell
momento - memento--momento is Spanish for "moment"
misterious - mysterious
neccessary - necessary
nieghbor - neighbor
noticable - noticeable
occassion - occasion
occurence - occurrence
oddyssey - odyssey
peice - piece
playwrite - playwright
preceed - precede
presance - presence
privelege - privilege
prophecy is a noun, while prophesy is a verb.
pumkin - pumpkin
rasberry - raspberry
recieve - receive
rtyhm - rhythm
sacriligious - sacrilegious
sience - science
sissors - scissors
seperate - separate
sinserely - sincerely
supercede - supersede
truely - truly
untill - until
till - until
Wensday - Wednesday
wether - whether
wich - which, or witch
wierd - weird